g--+--+
   |  +-+-+
x +++ | | |
| | | | s-+
+-+ +-+   |
  +-+ +-+-+
  +-----+